


                                      ########################


                              #############                #################              ####################      #########################                



                        ###########           ##############           #############       ###########                                              ###########



             ##########

                                                                                                                                                                                         $
#########################################      ##################          #################        ##################        #############################          ###############################